4444 4444 4444 4444 4444 4444 4444 4444 4444 4444 4444 4444 4444 4444 4444 4444 4444 4444 4444 4444 4444 4444 4444 4444 4444 4444 4444 4444 4444 4444 4444 4444 4444 4444 4444 4444 4444 4444
4444 0000 0000 0000 0000 0000 0000 0000 0000 0000 4444 0000 0000 0000 0000 4444 0000 0000 0000 0000 0000 3333 0000 0000 3444 0000 0000 0000 0000 0000 0000 C4444 0000 0000 0000 0000 0000 4444
4444 0000 0000 0000 0000 0000 0000 0000 0000 0000 D4444 0000 0000 0000 0000 4444 0000 0000 0000 0000 0000 3333 0000 0000 344C4 0000 0000 0000 0000 0000 0000 D4444 0000 0000 0000 0000 0000 4444
4444 0000 0000 0000 0000 0000 0000 0000 0000 0000 4444 0000 0000 0000 0000 4444 0000 0000 0000 0000 0000 0000 0000 0000 3444 0000 0000 0000 0000 0000 0000 C4444 0000 0000 0000 0000 0000 4444
4444 0000 0000 0000 0000 0000 0000 0000 0000 0000 4444 0000 0000 0000 0000 4444 0000 0000 0000 0000 0000 0000 0000 0000 344C4 0000 0000 0000 0000 0000 0000 4444 4444 4444 4444 D4444 4444 4444
4444 4444 4444 4444 4444 4444 4D444 4444 4444 4444 4444 0000 0000 0000 0000 4444 0000 0000 0000 0000 0000 3333 0000 0000 3444 0000 0000 0000 0000 0000 0000 C4444 0000 0000 0000 0000 0000 4444
4444 0000 0000 0000 3444 0000 0000 0000 0000 0000 0000 0000 0000 0000 0000 4444 3333 3333 333D3 3333 3333 3333 0000 0000 344C4 0000 0000 0000 0000 0000 0000 4444 0000 0000 0000 0000 0000 4444
4444 0000 0000 0000 3444 0000 0000 0000 0000 0000 0000 0000 0000 0000 0000 4444 0000 0000 0000 0000 0000 3333 0000 0000 3444 0000 0000 0000 0000 0000 0000 4444 0000 0000 0000 0000 0000 4444
4444 0000 0000 0000 3444 0000 0000 0000 0000 0000 0000 0000 0000 0000 0000 4444 0000 0000 0000 0000 0000 3333 0000 0000 0000 0000 0000 0000 0000 0000 0000 4444 0000 0000 0000 0000 0000 4444
4444 0000 0000 0000 3444 0000 0000 0000 0000 0000 0000 0000 0000 0000 0000 4444 0000 0000 0000 0000 0000 3333 0000 0000 3444 0000 0000 0000 0000 0000 0000 4444 0000 0000 0000 0000 0000 4444
4444 0000 0000 0000 3444 0000 0000 0000 0000 0000 0000 0000 0000 0000 0000 4444 0000 0000 0000 0000 0000 3333 0000 0000 3444 0000 0000 0000 0000 0000 0000 4444 0000 0000 0000 0000 0000 4444
4444 4344 434D4 4344 3444 4443 4443 4443 444D3 4443 4443 4444 4444 4444 4444 4444 0000 0000 0000 0000 0000 3333 0000 0000 3444 0000 0000 0000 0000 0000 0000 4444 0000 0000 0000 0000 0000 4444
4444 0000 0000 0000 3444 0000 0000 0000 0000 0000 0000 3333 0000 0000 0000 0000 0000 0000 0000 0000 0000 3333 0000 0000 3444 0000 0000 0000 0000 0000 0000 4444 0000 0000 0000 0000 0000 4444
4444 0000 0000 0000 3444 0000 0000 0000 0000 0000 0000 3333 0000 0000 0000 0000 0000 0000 0000 0000 0000 3333 4443 4443 3444 3444 3444 3444 3444 3444 344D4 3444 0000 0000 0000 0000 0000 4444
4444 0000 0000 0000 3444 0000 0000 0000 0000 0000 0000 3333 0000 0000 0000 0000 0000 0000 0000 0000 0000 0000 0000 3444 0000 0000 0000 0000 0000 0000 0000 3444 0000 0000 0000 0000 0000 4444
4444 0000 0000 0000 3444 0000 0000 0000 0000 0000 0000 3333 0000 0000 0000 0000 0000 0000 0000 0000 0000 0000 0000 3444 0000 0000 0000 0000 0000 0000 0000 3444 0000 0000 0000 0000 0000 4444
4444 0000 0000 0000 34D44 0000 0000 0000 0000 0000 0000 3333 0000 0000 0000 0000 0000 0000 0000 0000 0000 0000 0000 D3444 0000 0000 0000 0000 0000 0000 0000 3444 0000 0000 0000 0000 0000 4444
4444 0000 0000 0000 3444 0000 0000 0000 0000 0000 0000 3333 0000 0000 0000 0000 0000 0000 0000 0000 0000 3333 0000 3444 0000 0000 0000 0000 0000 0000 0000 3444 0000 0000 0000 0000 0000 4444
4444 0000 0000 0000 3444 0000 0000 0000 0000 0000 0000 3333 0000 0000 0000 0000 0000 0000 0000 0000 0000 3333 0000 3444 0000 0000 0000 0000 0000 0000 0000 3444 0000 0000 0000 0000 0000 4444
4444 0000 0000 0000 3444 0000 0000 0000 0000 0000 0000 3333 0000 0000 0000 0000 0000 0000 0000 0000 0000 3333 0000 3444 0000 0000 0000 0000 0000 0000 0000 3444 0000 0000 0000 0000 0000 4444
4444 0000 0000 0000 3444 0000 0000 0000 0000 0000 0000 D3333 0000 0000 0000 0000 0000 0000 0000 0000 0000 3333 0000 3444 0000 0000 0000 0000 0000 0000 0000 3444 0000 0000 0000 0000 0000 4444
4444 4444 4444 4444 4444 4444 4444 4444 4444 4444 4444 4444 4444 4444 4444 4444 4444 4444 4444 4444 4444 4444 4444 4444 4444 4444 4444 4444 4444 4444 4444 4444 4444 4444 4444 4444 4444 4444
