3333 3333 3333 3333 3333 3333 3333 3333 3333 3333 3333 3333 3333 3333 3333 3333 3333 3333 3333 3333 3333 3333 3333 3333 
3333 0000 0000 5555 0000 0000 5555 0000 0000 0000 5555 0000 0000 0000 0000 0000 0000 0000 0000 5555 0000 0000 0000 3333 
3333 0000 0000 D5555 0000 0000 5555 0000 0000 0000 5555 0000 0000 0000 0000 0000 0000 0000 0000 D5555 0000 0000 0000 3333 
3333 0000 0000 5555 0000 0000 5555 0000 0000 0000 5555 0000 0000 0000 0000 0000 0000 0000 0000 5555 0000 0000 0000 3333 
3333 0000 0000 5555 0000 0000 5555 0000 0000 0000 5555 5555 5555 5555 555D5 5555 5555 5555 5555 5555 0000 0000 0000 3333 
3333 5555 5555 5555 5555 5D555 5555 0000 0000 0000 0000 0000 0000 0000 0000 0000 0000 0000 0000 5555 0000 0000 0000 3333 
3333 0000 0000 0000 0000 0000 5555 0000 0000 0000 0000 0000 0000 0000 0000 0000 0000 0000 0000 5555 0000 0000 0000 3333 
3333 0000 0000 0000 0000 0000 5555 0000 0000 0000 0000 0000 0000 0000 0000 0000 0000 0000 0000 5555 0000 0000 0000 3333 
3333 0000 0000 0000 0000 0000 5555 0000 5555 5555 5555 5555 5555 5555 5555 5555 5555 5555 5555 5555 0000 0000 0000 3333 
3333 0000 0000 0000 0000 0000 5555 0000 5555 0000 0000 0000 555D5 0000 0000 0000 0000 0000 0000 5555 0000 0000 0000 3333 
3333 5555 0000 5555 5555 5555 5555 0000 5555 0000 0000 0000 5555 0000 0000 0000 0000 0000 0000 5555 0000 0000 0000 3333 
3333 0000 0000 0000 5555 0000 0000 0000 5555 0000 0000 0000 5555 0000 0000 0000 0000 0000 0000 5555 0000 0000 0000 3333 
3333 0000 0000 0000 5555 0000 0000 0000 5555 0000 0000 0000 5555 0000 0000 0000 0000 0000 0000 5555 0000 0000 0000 3333 
3333 0000 0000 0000 5555 0000 0000 0000 5555 0000 0000 0000 5555 0000 0000 0000 0000 0000 0000 5555 0000 0000 0000 3333 
3333 0000 0000 0000 5555 0000 0000 0000 5555 5555 5555 5555 5555 5555 0000 0000 0000 0000 0000 5555 0000 0000 0000 3333 
3333 0000 0000 0000 5555 0000 0000 0000 0000 0000 5555 0000 0000 5555 0000 0000 0000 0000 0000 5555 0000 0000 0000 3333 
3333 0000 0000 0000 5555 0000 0000 0000 0000 0000 5555 0000 0000 5555 0000 0000 0000 0000 0000 5555 0000 0000 0000 3333 
3333 0000 0000 0000 5555 0000 0000 0000 0000 0000 5555 0000 0000 D5555 0000 0000 0000 0000 0000 5555 0000 0000 0000 3333 
3333 0000 0000 0000 5555 0000 0000 0000 0000 0000 5555 0000 0000 5555 5555 5555 5555 5555 5555 5555 5555 5555 5D555 3333 
3333 0000 0000 0000 5555 0000 0000 0000 0000 0000 5555 0000 0000 5555 0000 0000 0000 0000 0000 0000 0000 0000 0000 3333 
3333 0000 0000 0000 D5555 0000 0000 0000 0000 0000 5555 0000 0000 5555 0000 0000 0000 0000 0000 0000 0000 0000 0000 3333 
3333 0000 0000 0000 5555 0000 0000 0000 0000 0000 5555 0000 0000 55D55 0000 0000 0000 0000 0000 0000 0000 0000 0000 3333 
3333 0000 0000 0000 5555 0000 0000 0000 0000 0000 5555 0000 0000 5555 0000 0000 0000 0000 0000 0000 0000 0000 0000 3333 
3333 3333 3333 3333 3333 3333 3333 3333 3333 3333 3333 3333 3333 3333 3333 3333 3333 3333 3333 3333 3333 3333 3333 3333